NO ./textures/north.xpm
SO ./textures/south.xpm
EA ./textures/east.xpm
WE ./textures/west.xpm

F 255,204,153
C 0,51,102

11111111
10000001
10001101
10E00001
10000111
11111111
