NO ./cub3D
SO ./cub3D
EA ./cub3D    
WE ./cub3D
F 220,210,0
C 225,30,0
111111111111111111
100000000011000001
101100000111000001
100100000000000001
111111N11011000001
100000000000000001
100000000000000001
100000000000000001
100000000000000001
100000000000000001
100000000000000001
100000000000000001
100000000000000001
100000000011000001
110000011101010111
111101111111010111
111111111111111111
111111111111111111
100000000011000001
101100000111000001
100100000000000001
111111N11011000001
100000000000000001
100000000000000001
100000000000000001
100000000000000001
100000000000000001
100000000000000001
100000000000000001
100000000000000001
100000000011000001
110000011101010111
111101111111010111
111111111111111111