NO ./textures/debug_north5.xpm
SO ./textures/debug_north5.xpm
EA ./textures/debug_east5.xpm
WE ./textures/debug_east5.xpm
F 255,204,153
C 0,51,102
1111111111111111111111111111111111111111111111111111111111111111111111111111111111111
1000000000110000000000001111111111111111111111111111111111111111111111111111111111111
1011000001110000000000001111111111111111111111111111111111111111111111111111111111111
1001000000000000000000001111111111111111111111111111111111111111111111111111111111111
111111N110110000011100000000000000000000000000000000000000000000000000000000000000001
1000000000000000000000000000000000000000000000000000000000000000000000000000000000001
1000000000000000000000000000000000000000000000000000000000000000000000000000000000001
1000000000000000000000000000000000000000000000000000000000000000000000000000000000001
1000000000000000000000000000000011111111111111111111111111111111111111111111111111111
1000000000000000000000000000000011111111111111111111111111111111111111111111111111111
1000000000000000000000000000000011111111111111111111111111111111111111111111111111111
1000000000000000000000000000000011111111111111111111111111111111111111111111111111111
1000000000000000000000000000000011111111111111111111111111111111111111111111111111111
1000000000110000011101111111111111111111111111111111111111111111111111111111111111111
1100000111010101111101111000111111111111111111111111111111111111111111111111111111111
1111011111110101110111101000111111111111111111111111111111111111111111111111111111111
1111111111111111111111111111111111111111111111111111111111111111111111111111111111111
