NO ./cub3D
SO ./cub3D
EA ./cub3D    
WE ./cub3D
F 220,210,0
C 225,30,0
1111111111111111111111111
1000000000110000000000001
1011000001110000000000001
1001000000000000000000001111111111111111111111111111111111111111111111111111111111111
111111N110110000011100000000000000000000000000000000000000000000000000000000000000001
1000000000000000000000000000000000000000000000000000000000000000000000000000000000001
1000000000000000000000000000000000000000000000000000000000000000000000000000000000001
1000000000000000000000000000000000000000000000000000000000000000000000000000000000001
100000000000000000000000000000001111111111111111111111111111111111111111111111111111111111111
100000000000000000000000000000001
100000000000000000000000000000001
100000000000000000000000000000001
100000000000000000000000000000001
100000000011000001110111111111111
1100000111010101111101111000111
11110111 1110101 101111010001
1111111111111111111111111111