NO ./textures/debug_north3.xpm
SO ./textures/debug_north5.xpm
EA ./textures/debug_east5.xpm
WE ./textures/debug_east5.xpm
F 255,204,153
C 0,51,102
111111111111111111
100000000111111111
1000000W0001111111
100000000001111111
111111111111111111