                 NO ./cub3D
   
  SO ./cub3D
     
              EA ./cub3D    
       WE ./cub3D
       
    
F      220,210,0
C 225,30,0
   
111111111111111111111111111
10N000100110000000000001001111111
101100000110000000000001000000001
100100000000000000000000111111111
111111111011000001110000000000001
10000000001100000111011111111111111
1111011111111111111110111000000100011
111101111111111011101010010001111111
1100000011010101110000001000111111111
10000000000000001100000010001
10000000000000001101010010001
11000001110101011111011110001111111
11110111101110101101111010001000001
11111111101111111111111111111111111