    NO ./textures/debug_north3.xpm

  SO            ./textures/debug_north5.xpm
EA ./textures/debug_east5.xpm
      WE ./textures/debug_east5.xpm
F 255,204,153
C 0,51,102

111111111111      11111111
111111111111111111
1111111111111111111111111111
10111111010101    10101111101
1111111111111111111111111111
100000W000011110111101111
1111111111111111111110001
1111111111111111111111111