NO ./cub3D
SO ./cub3D
EA ./cub3D    
WE ./cub3D
   
F 220,210,0
C 225,30,0
   
1111111
100E101
11111101
11100011
11111111
