                 NO ./cub3D
   
  SO ./cub3D
     
              EA ./cub3D    
       WE ./cub3D
       
    
F      220,100,0
C 225,30,0
   
111111111111111111111111110
100000 00110000000000001001111111
101100000110000000000001000000001
100100000000000000000000111111111
111111111011000001110000000000001
10000000001100000111011111111111111
1111011111111111111110111000000100011
11110111111W111011101010010001111111
1100000011010101110000001000111111111
10000000000000001100000010001
10000000000000001101010010001
1100000111010101111101111000111
11110111101110101101111010001
111111111011111111111111111111