NO ./cub3D
SO ./cub3D
EA ./cub3D    
WE ./cub3D
 
F 220,210,0
C 225,30,0
   
111111111111111111111111111111111
1000001001100000000000010011011101
10110010011000000000000W1000000001
100100000000000000000000111111111
111111111011000001110000000000001
10000000001100000111011111111111111
0111011111111111111110111110000100011
11110111111111101110101   10010001111111
11000000110101011100000111110111111111
100000001 111000000001100000010000111
1000000001100000110101001000011111101
110000011101010111110111100011111111
1111011110111010110111101000100000101111
111111111111110111111111 111111111111101
1111111111111111111111111111111111111111