NO ./cub3D
SO ./cub3D
EA ./cub3D    
WE ./cub3D
 
F 220,210,0
C 225,30,0
   
111111
100011
11100W1
111111