1111111111
1000000001
1011000001
1001000001
1111111111
1000000001
1111011111
1111011111
1100000011
1111111111
