NO ./textures/north1.xpm
SO ./textures/south1.xpm
EA ./textures/east1.xpm
WE ./textures/west1.xpm
F 255,204,153
C 0,51,102
111111111111111111111111111
111111111111111111111111111
110000000000000000000000011
110110000011100000000000011
110010000001000000000000011
1111000E0001000000111000011
110000000001100000111011111
111000001110101011111011111
111110111111101011101111011
111111111111111111111111111
111111111111111111111111111
