NO ./textures/north.xpm
SO ./textures/south.xpm
EA ./textures/east.xpm
WE ./textures/west.xpm
F 255,204,153
C 0,51,102

111111111111      11111111
1111111111111111111111111111
11111111111111111111111111W1
10111111010101    10101111101
1111111111111111111111111111
1000000000011110111101111
1111111111111111111110001
1111111111111111111111111