NO ./textures/north.xpm
SO ./textures/south.xpm
EA ./textures/east.xpm
WE ./textures/west.xpm    

F 220,210,0
C 225,30,0
1111111111111111111111111
1000000000110000000000001
10110000011100E0000000001
10010000000000000000000011
1111111101100000111000011
1111111111111111111111111