NO ./textures/debug_north3.xpm
SO ./textures/debug_north5.xpm
EA ./textures/debug_east5.xpm
WE ./textures/debug_east5.xpm
F 255,204,153
C 0,51,102
1111111111111111111111111
1000000000110000000000001
1011000001110000000000001
1001000000000000000000001111111111111111111111111111111111111111111111111111111111111
111111N110110000011100000000000000000000000000000000000000000000000000000000000000001
1000000000000000000000000000000000000000000000000000000000000000000000000000000000001
1000000000000000000000000000000000000000000000000000000000000000000000000000000000001
1000000000000000000000000000000000000000000000000000000000000000000000000000000000001
100000000000000000000000000000001111111111111111111111111111111111111111111111111111111111111
10000000000000000000000000000001
100000000000000000000000000000001
100000000000000000000000000000001
100000000000000000000000000000001
100000000011000001110111111111111
1100000111010101111101111000111
11110111111010110111101000101
11111111111111111111111111111
