NO     ./cub3D
    
SO ./cub3D
EA ./cub3D    
WE ./cub3D
F 220,100,0
C 225,30,0
1111111111111111111111111
1000000000110000000000001
1011000001110000000000001
100100000000000000000000111111111
111111E11011000001110000000000001
100000000011000001110111111111111
1100000111010101111101111000111
11110111 1110101 101111010001
1111111111111111111111111111
111
111
111
111
111
101
111