NO ./textures/autre/north1.xpm
SO ./textures/autre/south1.xpm
EA ./textures/autre/east1.xpm
WE ./textures/autre/west1.xpm
F 255,204,153
C 0,51,102
111111111111111111111111111
111111111111111111111111111
110000100000000000000000011
110000110011100000000000011
110000001001000000000000011
1111000E0001000000111000011
110000000001100000111011111
111000001110101011111011111
111110111111101011101111011
111111111111111111111111111
111111111111111111111111111
