      
NO ./textures/north.xpm
SO ./textures/south.xpm
EA ./textures/east.xpm
WE ./textures/west.xpm
F 220,100,0
C 225,30,0
1111111111111111111111111
1000W00000110000000000001
10110000011100000W0000001
1111111111111111111111111
