NO ./textures/debug_north5.xpm
SO ./textures/debug_north5.xpm
EA ./textures/debug_east5.xpm

WE ./textures/debug_east5.xpm
F 255,204,153
C 0,51,102

1111111111111111111111111
1a00000000110000000000001
1011000001110000000000001
1001000000000000000000001
111111111011000001110000000000001
100000000011000001110111111111111
11111111111111111111111111
